LEVEL,10,7
M,M,M,M,M,M,M,M,M,M
M,P,B,B,B,B,B,B,B,M
M,B,B,B,B,B,B,B,B,M
M,B,B,B,B,B,B,B,B,M
M,B,B,B,B,B,B,B,B,M
M,B,B,B,B,B,B,B,S,M
M,M,M,M,M,M,M,M,M,M